10 0 0
10 0 1 U
10 1 0 L
10 2 0 L
10 3 0 L
10 3 1 U
10 4 0 R -18
10 4 1 U
10 4 2 U
10 5 0 L
10 5 1 U
10 6 0 L
10 6 1 U 1
10 6 2 U
